cntry - Country
gndr - Gender
nwspol - News about politics and current affairs, watching, reading or listening, in minutes
netusoft - Internet use, how often
netustm - Internet use, how much time on typical day, in minutes
ppltrst - Most people can be trusted or you can't be too careful
pplfair - Most people try to take advantage of you, or try to be fair
pplhlp - Most of the time people helpful or mostly looking out for themselves
polintr - How interested in politics
psppsgva - Political system allows people to have a say in what government does
actrolga - Able to take active role in political group
psppipla - Political system allows people to have influence on politics
cptppola - Confident in own ability to participate in politics
trstprl - Trust in country's parliament
trstlgl - Trust in the legal system
trstplc - Trust in the police
trstplt - Trust in politicians
trstprt - Trust in political parties
trstep - Trust in the European Parliament
trstun - Trust in the United Nations
trstsci - Trust in scientists
vote - Voted last national election
contplt - Contacted politician or government official last 12 months
donprty - Donated to or participated in political party or pressure group last 12 months
badge - Worn or displayed campaign badge/sticker last 12 months
sgnptit - Signed petition last 12 months
pbldmna - Taken part in public demonstration last 12 months
pstplonl - Posted or shared anything about politics online last 12 months
volunfp - Volunteered for not-for-profit or charitable organisation
clsprty - Feel closer to a particular party than all other parties
lrscale - Placement on left right scale
stflife - How satisfied with life as a whole
stfeco - How satisfied with present state of economy in country
stfgov - How satisfied with the national government
stfdem - How satisfied with the way democracy works in country
stfedu - State of education in country nowadays
stfhlth - State of health services in country nowadays
gincdif - Government should reduce differences in income levels
freehms - Gays and lesbians free to live life as they wish
hmsfmlsh - Ashamed if close family member gay or lesbian
hmsacld - Gay and lesbian couples right to adopt children
euftf - European Union: European unification go further or gone too far
lrnobed - Obedience and respect for authority most important virtues children should learn
loylead - Country needs most loyalty towards its leaders
imsmetn - Allow many/few immigrants of same race/ethnic group as majority
imdfetn - Allow many/few immigrants of different race/ethnic group from majority
impcntr - Allow many/few immigrants from poorer countries outside Europe
imbgeco - Immigration bad or good for country's economy
imueclt - Country's cultural life undermined or enriched by immigrants
imwbcnt - Immigrants make country worse or better place to live
happy - How happy are you
sclmeet - How often socially meet with friends, relatives or colleagues
inprdsc - How many people with whom you can discuss intimate and personal matters
sclact - Take part in social activities compared to others of same age
crmvct - Respondent or household member victim of burglary/assault last 5 years
aesfdrk - Feeling of safety of walking alone in local area after dark
health - Subjective general health
hlthhmp - Hampered in daily activities by illness/disability/infirmity/mental problem
atcherp - How emotionally attached to Europe
rlgblg - Belonging to particular religion or denomination
rlgdnm - Religion or denomination belonging to at present
rlgdgr - How religious are you
rlgatnd - How often attend religious services apart from special occasions
pray - How often pray apart from at religious services
brncntr - Born in country
facntr - Father born in country
mocntr - Mother born in country
ccnthum - Climate change caused by natural processes, human activity, or both
wrclmch - How worried about climate change
fairelc - National elections are free and fair
dfprtal - Different political parties offer clear alternatives to one another
medcrgv - The media are free to criticise the government
rghmgpr - The rights of minority groups are protected
votedir - Citizens have the final say on political issues by voting directly in referendums
cttresa - The courts treat everyone the same
gptpelc - Governing parties are punished in elections when they have done a bad job
gvctzpv - The government protects all citizens against poverty
grdfinc - The government takes measures to reduce differences in income levels
viepol - The views of ordinary people prevail over the views of the political elite
wpestop - The will of the people cannot be stopped
keydec - Key decisions are made by national governments rather than the European Union
chpldm - Best for democracy: government changes policies in response to what most people think
chpldmi - Important for democracy: government changes policies in response to what most people think
chpldmc - In country government changes policies in response to what most people think
stpldmi - Important for democracy: government sticks to policies regardless of what most people think
stpldmc - In country government sticks to policies regardless of what most people think
implvdm - How important for you to live in democratically governed country
accalaw - Acceptable for country to have a strong leader above the law
ipcrtiv - Important to think new ideas and being creative
imprich - Important to be rich, have money and expensive things
ipeqopt - Important that people are treated equally and have equal opportunities
ipshabt - Important to show abilities and be admired
impsafe - Important to live in secure and safe surroundings
impdiff - Important to try new and different things in life
ipfrule - Important to do what is told and follow rules
ipudrst - Important to understand different people
ipmodst - Important to be humble and modest, not draw attention
ipgdtim - Important to have a good time
impfree - Important to make own decisions and be free
iphlppl - Important to help people and care for others well-being
ipsuces - Important to be successful and that people recognise achievements
ipstrgv - Important that government is strong and ensures safety
ipadvnt - Important to seek adventures and have an exciting life
ipbhprp - Important to behave properly
iprspot - Important to get respect from others
iplylfr - Important to be loyal to friends and devote to people close
impenv - Important to care for nature and environment
imptrad - Important to follow traditions and customs
impfun - Important to seek fun and things that give pleasure
secgrdec - Small secret group of people responsible for making all major decisions in world politics
scidecpb - Groups of scientists manipulate, fabricate, or suppress evidence in order to deceive the public
govpriph - More important for governments to prioritise public health or economic activity
govmonpb - More important for governments to monitor and track the public or to maintain public privacy
panfolru - More important to follow government rules or to make own decisions when fighting a pandemic
panclobo - How important for country to close its borders when fighting a pandemic
panresmo - How important to restrict people's movement between different parts of country when fighting a pandemic
gvhanc19 - How satisfied with government's handling of COVID-19 in country
gvjobc19 - How satisfied with government's response to COVID-19: people who have experienced job/income losses
gveldc19 - How satisfied with government's response to COVID-19: elderly people in care homes
gvfamc19 - How satisfied with government's response to COVID-19: families with school-aged children
hscopc19 - How satisfied with the way health services coped with COVID-19 and its consequences in country
gvbalc19 - How the government balanced protecting the economy and people's health when responding to COVID-19 in country
gvimpc19 - To what extent trust the government to deal with the impact of COVID-19 in country
gvconc19 - COVID-19 is result of deliberate and concealed efforts of some government or organisation
respc19 - Respondent had COVID-19
rshpsts - Relationship with husband/wife/partner currently living with
lvgptnea - Ever lived with a partner, without being married
dvrcdeva - Ever been divorced/had civil union dissolved
marsts - Legal marital status


'BE','BG','CH','CZ','EE','FI','FR','GB','GR','HR','HU','IE','IS','IT','LT','ME','MK','NL','NO','PT','SI','SK'